
#உள்ளீடு: data/chorkuviyal.22mar22.suffix.sorted.txt
#வெளியீடு: data/arivaal/output.txt
நிராகரிக்கப்பட்டமைக்கான	நிராகரிக்கப்பட்டமைக்கான
புகலிடக்கோரிக்கையாளர்களுக்கான	புகலிடக்கோரிக்கையாளர்களுக்கான
இருப்பவர்களுக்கெல்லாம்	இருப்பவர்களுக்கெல்லாம்
மாற்றுத்திறனாளியிடம்	மாற்றுத்திறனாளியிடம்
செய்துகொண்டிருக்கிறாராம்	செய்துகொண்டிருக்கிறாராம்
வெளிப்படுத்துவதாகும்	வெளிப்படுத்துவதாகும்
தொங்கவிடப்பட்டுள்ளது	தொங்கவிடப்பட்டுள்ளது
விட்டுக்கொடுக்கக்கூடாது	விட்டுக்கொடுக்கக்கூடாது
மறுமலர்ச்சிக்காகவும்	மறுமலர்ச்சிக்காகவும்
இந்தியப்பெருநிலத்தின்	இந்தியப்பெருநிலத்தின்
ஈடுபடுத்திக்கொண்டேன்	ஈடுபடுத்திக்கொண்டேன்
சிவபாதசுந்தரக்குருக்கள்	சிவபாதசுந்தரக்குருக்கள்
அமல்படுத்தப்போவதில்லை	அமல்படுத்தப்போவதில்லை
தொடர்புப்படுத்தப்பட்டுள்ளது	தொடர்புப்படுத்தப்பட்டுள்ளது
வழங்கப்படுவதில்லையென	வழங்கப்படுவதில்லையென
பெறப்பட்டிருந்தாலும்	பெறப்பட்டிருந்தாலும்
பத்திரிகையாளர்கள்தான்	பத்திரிகையாளர்கள்தான்
அழித்துக்கொண்டிருக்கும்	அழித்துக்கொண்டிருக்கும்
விரிக்கப்பட்டிருக்கிறது	விரிக்கப்பட்டிருக்கிறது
அங்கீகரிக்கப்பட்டிருக்க	அங்கீகரிக்கப்பட்டிருக்க
கட்டிக்கொண்டிருக்கிறோம்	கட்டிக்கொண்டிருக்கிறோம்
ஆரம்பித்திருப்பீர்கள்	ஆரம்பித்திருப்பீர்கள்
சர்வசாதாரணமாகிவிட்டது	சர்வசாதாரணமாகிவிட்டது
சிந்தித்திருக்கின்றனர்	சிந்தித்திருக்கின்றனர்
பிரதிநிதித்துவத்தைப்	பிரதிநிதித்துவத்தைப்
பரிணமித்திருந்தாலும்	பரிணமித்திருந்தாலும்
சுவீகரிக்கப்பட்டுள்ள	சுவீகரிக்கப்பட்டுள்ள
நினைத்துக்கொள்ளுங்கள்	நினைத்துக்கொள்ளுங்கள்
அதிகப்படுத்துவதுதான்	அதிகப்படுத்துவதுதான்
பார்க்கப்படுகின்றனர்	பார்க்கப்படுகின்றனர்
சிகிச்சையளிக்கப்பட்டு	சிகிச்சையளிக்கப்பட்டு
தீர்க்கப்பட்டுவிட்டது	தீர்க்கப்பட்டுவிட்டது
கலந்தாலோசித்துள்ளனர்	கலந்தாலோசித்துள்ளனர்
வேடிக்கையென்னவென்றால்	வேடிக்கையென்னவென்றால்
அலுவலகத்திலிருக்கும்	அலுவலகத்திலிருக்கும்
நினைவுபடுத்திக்கொள்ளுங்கள்	நினைவுபடுத்திக்கொள்ளுங்கள்
செய்யப்படும்போதுதான்	செய்யப்படும்போதுதான்
விண்ணப்பிப்பவா்களுக்கு	விண்ணப்பிப்பவா்களுக்கு
துன்புறுத்துவோருக்கு	துன்புறுத்துவோருக்கு
அறிமுகப்படுத்துவதுதான்	அறிமுகப்படுத்துவதுதான்
துன்புறுத்தப்படுவதற்கு	துன்புறுத்தப்படுவதற்கு
பாதிக்கப்பட்டுஉள்ளனர்	பாதிக்கப்பட்டுஉள்ளனர்
பதிவிடப்பட்டிருக்கும்	பதிவிடப்பட்டிருக்கும்
தனியார்மருத்துவமனையில்	தனியார்மருத்துவமனையில்
இணைக்கப்பட்டிருக்கலாம்	இணைக்கப்பட்டிருக்கலாம்
களமிறக்கப்பட்டுள்ளது	களமிறக்கப்பட்டுள்ளது
கட்டாயப்படுத்துகிறார்கள்	கட்டாயப்படுத்துகிறார்கள்
எடுத்துள்ளவர்களுக்கு	எடுத்துள்ளவர்களுக்கு
பிரசுரிக்கப்பட்டிருந்தன	பிரசுரிக்கப்பட்டிருந்தன
சந்தித்துக்கொண்டிருக்கின்றன	சந்தித்துக்கொண்டிருக்கின்றன
அப்செட்டாக்கியுள்ளது	அப்செட்டாக்கியுள்ளது
முன்வைத்திருக்கிறீர்கள்	முன்வைத்திருக்கிறீர்கள்
இழிவுபடுத்தியுள்ளதாக	இழிவுபடுத்தியுள்ளதாக
வாடிக்கையாளர்கள்தான்	வாடிக்கையாளர்கள்தான்
கண்டுபிடிக்கப்படாமலே	கண்டுபிடிக்கப்படாமலே
அப்புறப்படுத்தியுள்ளார்	அப்புறப்படுத்தியுள்ளார்
மகிழ்ச்சியளிப்பதாகத்	மகிழ்ச்சியளிப்பதாகத்
மாற்றங்களுக்குள்ளாகி	மாற்றங்களுக்குள்ளாகி
கண்டுபிடிக்கப்படாததால்	கண்டுபிடிக்கப்படாததால்
எதிர்கொண்டிருக்கிறார்	எதிர்கொண்டிருக்கிறார்
மசூலிப்பட்டினத்திலும்	மசூலிப்பட்டினத்திலும்
வேட்டையாடப்படுகிறார்கள்	வேட்டையாடப்படுகிறார்கள்
